%%%%%%%
%.GG..%
%.....%
%.....%
%.....%
%.P...%
%%%%%%%